111111111111111111111111
100000000000000C00000001
101E01010010000010110101
1P1001001010101000110101
100000000C00C000000000C1
111111111111111111111111